1111111111111
1X000000000X1
10000000000C1
100C00E000CP1
10000000000C1
1X000000000X1
1111111111111