1111111111111111
10X1000000000001
1000011111011001
1C0P11C0X00E00C1
1001000000000001
1000011111C11C01
1001000000000001
1000C11111X11001
1111111111111111