1111111111111
1001000000001
1000011111011
1C0P11C0000E1
1111111111111