1111111111111111
1001000000000001
1000011111011001
1C0P11C0000E00C1
1111111111111111