111111111111111111111111111111111111111111111
1P000000000000000000CCCCCCCCCCCC0000000000001
111111111111111111111111111111111111111111101
1ECCCCCCCCCCCCCCCCCCCCCCCCCCCCCCCCCCCCCCCCCC1
111111111111111111111111111111111111111111111