11111111
1CCCCCC1
1C00E0C1
1C00P0C1
1CCCCCC1
11111111