1111111111111111
1CCCCCC000000001
1C0000C100000001
1C00P0C100000001
1CCCCCC1CCCCCCE1
1111111111111111