111111111111111111111111111111111111111111111
11000000000000000001C000011111100000000000C01
111111111110111111011000011111101110001110101
10001001110000C111001110001001010001000100101
111011111111011111100000000010101010101010101
111011111111011111111111111001111111000000101
100000000001000000000000000100000011011111111
111100000001000111111110010100C10100000000001
111101111111111111111110111110111111111111101
1111011111100000011000001111C00000001000001C1
1C000000001000000010C0P0000100000100000100001
1111111110111111101111E1111111111111111111101
1111111100000000101C1C1C1C1010101010101010101
1C0000000100001000001000000011110000000000001
111111111111111110111111111011111101111111101
10000000000000000000000100101111000000000C1C1
1C00000001000111111111110010000C0000000000111
1111111111110000100C0000001101111111111110001
10000111010101C11000101111110111111C1111111C1
10000000000001100001CCC11110000CCC10000000001
110011111111111010110000011111011111111111101
1100000000000000100000000000000100000010000C1
111111111111111111111111111111111111111111111