111111111111111111111111111111111111111111111
1P000000000000000000C000011111100000000000C01
111111111110111111111000011111101110001110101
100010011100000111001110001001010001000100101
111011111111011111111111100010101010101010101
111011111111011111111111111001111111000000101
100000000000000000000000000000000011011111111
111100000000000111111110010100CC0000000000001
111101111111111111111111111110111111111111101
1111011111100000011111111111CCCCCCCCCCCCCCCC1
1C000000000000000000CCCCCCCCCCCC0000000000001
1111111111111111111111E1111111111111111111101
111111110000000010101010101010101010101010101
1C000000000000000000CCCCCCCC11110000000000001
111111111111111111111111111011111111111111101
100000000000000000000000E0001111000000000CCC1
1C0000000000011111111111CCCCCCCC0000000000001
1111111111111000000C0000001111111111111111101
10000111000111C11000101111111111111C1111111C1
10000000000000000000CCC11110000CCC00000000001
11001111111111111111000E011111111111111111101
1100000000000000000000000000000000000000000C1
111111111111111111111111111111111111111111111
